11111111111111111111111111111111
110C0000000000000000000000000001
10E0C000000000000000000000000001
10P0010100000T00000C00000C000001
11000001C000000000000010000C0001
1000000100000000000C0010000C0001
100000C0000000000000000000000001
100000000C0000000C00000000000101
100000000000000000000000000001C1
11111111111111111111111111111111